11111111111111111111111111111111111111
10000000000000000000000000000000000001
10000000000000000000000000000000001001
1000000000000000000000P000000000001001
10000000000000000000000000000000001001
10000000000000000000000000000000001001
10000000000000000000000000000000001001
10000000000000000000000000000000001001
10000000000000000000001111111111110001
10000000000000000000001E000000C0000001
11000000000000000000001111111111111001
11100000000000000000000000000000111011
1111000000000000000C000000000000111011
11100000000000000000000000000000000001
1000000C000000000000000000001111111111
11111111111111111111111111111111111111