111111111111111
1P0000000000011
101111111110011
101000000010011
101011111010011
101010001010011
101010C01010011
101011101011111
101000001000001
111101111101E11
100001000001001
111111111111111