1111111111111
10000000000E1
1P00000000111
1000000011111
10000000000C1
1000000000001
1001000000001
10C1000000001
1111000000C01
1111111111111