1111111111111
10000000000E1
1000000000111
1000000011111
10000000000C1
1000000000001
1001000000001
1001000000001
1111000000001
100000000P001
1111111111111